O←
o→
0↓
.↑
  ******
*   *  *
*** * **
**  * **
*  *#  *
** *** *
**     *
********
o0oo00O000oooo..OO